Aceranza	Aceranza	IT	modern
Acquarossa	Acquarossa	IT	ancient
Alessandria	Alessandria	IT	modern
Anzio	Anzio	IT	modern
Ardea	Ardea	IT	modern
Adria	Adria	IT	modern
Agrigento	Agrigento	IT	modern
Amalfi	Amalfi	IT	modern
Ancona	Ancona	IT	modern
Andria	Andria	IT	modern
Aquileia	Aquileia	IT	modern
Ariano	Ariano	IT	modern
Arezzo	Arezzo	IT	modern
Arpi	Arpi	IT	ancient
Assisi	Assisi	IT	modern
Aversa	Aversa	IT	modern
Bari	Bari	IT	modern
Benevento	Benevento	IT	modern
Bisignano	Bisignano	IT	modern
Bojano	Bojano	IT	modern
Bologna	Bologna	IT	modern
Bolsena	Bolsena	IT	modern
Brescia	Brescia	IT	modern
Brindisi	Brindisi	IT	modern
Buonalbergo	Buonalbergo	IT	modern
Butera	Butera	IT	modern
Camerino	Camerino	IT	modern
Capua	Capua	IT	modern
Casale Monferrato	Casale Monferrato	IT	modern
Cassino	Cassino	IT	modern
Castelseprio	Castelseprio	IT	medieval
Catania	Catania	IT	modern
Cefalu	Cefalu	IT	modern
Cerveteri	Cerveteri	IT	modern
Chieti	Chieti	IT	modern
Chiusi	Chiusi	IT	modern
Cividale del Friuli	Cividale del Friuli	IT	modern
Como	Como	IT	modern
Cortona	Cortona	IT	modern
Cosenza	Cosenza	IT	modern
Cremona	Cremona	IT	modern
Crotone	Crotone	IT	modern
Cumae	Cumae	IT	ancient
Enna	Enna	IT	modern
Falerii	Civita Castellana	IT	modern
Ferrara	Ferrara	IT	modern
Florence	Firenze	IT	modern
Foggia	Foggia	IT	modern
Gabii	Gabii	IT	ancient
Gaeta	Gaeta	IT	modern
Galeria	Galeria	IT	modern
Gallipoli	Gallipoli	IT	modern
Genoa	Genoa	IT	modern
Gerace	Gerace	IT	modern
Giardini-Naxos	Giardini-Naxos	IT	modern
Grado	Grado	IT	modern
Heraclea	Heraclea	IT	ancient
Ivrea	Ivrea	IT	modern
L'Aquila	L'Aquila	IT	modern
Larino	Larino	IT	modern
Lavello	Lavello	IT	modern
Lavinium	Lavinium	IT	ancient
Lecce	Lecce	IT	modern
Loreto	Loreto	IT	modern
Lucca	Lucca	IT	modern
Luni	Luni	IT	ancient
Mantua	Mantova	IT	modern
Marsala	Marsala	IT	modern
Matera	Matera	IT	modern
Mazara	Mazara	IT	modern
Melfi	Melfi	IT	modern
Messina	Messina	IT	modern
Milan	Milano	IT	modern
Milazzo	Milazzo	IT	modern
Mileto	Mileto	IT	modern
Modena	Modena	IT	modern
Monopoli	Monopoli	IT	modern
Montepeloso	Montepeloso	IT	modern
Montescaglioso	Montescaglioso	IT	modern
Murlo	Murlo	IT	modern
Naples	Napoli	IT	modern
Nardo	Nardo	IT	modern
Nicastro	Nicastro	IT	modern
Nola	Nola	IT	modern
Noto	Noto	IT	modern
Oria	Oria	IT	modern
Orvieto	Orvieto	IT	modern
Ostia	Ostia	IT	ancient
Otranto	Otranto	IT	modern
Palestrina	Palestrina	IT	modern
Palermo	Palermo	IT	modern
Parma	Parma	IT	modern
Padua	Padova	IT	modern
Paterno	Paterno	IT	modern
Pavia	Pavia	IT	modern
Perugia	Perugia	IT	modern
Piacenza	Piacenza	IT	modern
Pisa	Pisa	IT	modern
Policastro	Policastro	IT	modern
Polignano	Polignano	IT	modern
Pompeii	Pompeii	IT	ancient
Pontecorvo	Pontecorvo	IT	modern
Populonia	Populonia	IT	ancient
Potenza	Potenza	IT	modern
Ragusa	Ragusa	IT	modern
Ravenna	Ravenna	IT	modern
Reggio Calabria	Reggio Calabria	IT	modern
Rimini	Rimini	IT	modern
Rome	Rome	IT	modern
Rossano	Rossano	IT	modern
Rusellae	Rusellae	IT	ancient
Salerno	Salerno	IT	modern
Saluzzo	Saluzzo	IT	modern
Circeii	San Felice Circeo	IT	ancient
San Marco	San Marco	IT	modern
San Marino	San Marino	SM	modern
Santa Severina	Santa Severina	IT	modern
Savona	Savona	IT	modern
Scalea	Scalea	IT	modern
Scribla	Scribla	IT	modern
Siena	Siena	IT	modern
Sipontum	Sipontum	IT	ancient
Sorrento	Sorrento	IT	modern
Spina	Spina	IT	ancient
Spoleto	Spoleto	IT	modern
Squillace	Squillace	IT	modern
Sybaris	Sybaris	IT	ancient
Syracuse	Siracusa	IT	modern
Taormina	Taormina	IT	modern
Taranto	Taranto	IT	modern
Tarquinia	Tarquinia	IT	modern
Terracina	Terracina	IT	modern
Thurii	Thurii	IT	ancient
Tivoli	Tivoli	IT	modern
Todi	Todi	IT	modern
Trani	Trani	IT	modern
Trapani	Trapani	IT	modern
Trento	Trento	IT	modern
Treviso	Treviso	IT	modern
Tricarico	Tricarico	IT	modern
Tropea	Tropea	IT	modern
Troina	Troina	IT	modern
Turin	Turin	IT	modern
Veii	Veii	IT	ancient
Velia	Velia	IT	ancient
Venice	Venezia	IT	modern
Venosa	Venosa	IT	modern
Verona	Verona	IT	modern
Vetulonia	Vetulonia	IT	modern
Volterra	Volterra	IT	modern
Vulci	Vulci	IT	ancient
